$$$$$$$$$$$$$$$$$$$$
$2  ##   #    #   3$
$ # ## # #    #    $
$ # # #  #    # #  $
$# ##    #    # #  $
$#  ##  # #     #  $
$      #  #     #  $
$   ##   #         $
$ # ## # #   #  #  $
$ # # #  #         $
$# ##    #    #    $
$#  ##  # #   ###  $
$      #  #   #    $
$   ##   #         $
$ # ## # #    #    $
$ # # #  #     #   $
$# ##    #    # #  $
$#  ##  # #   #   #$
$4     #  #   #   1$
$$$$$$$$$$$$$$$$$$$$
